1 13 31
###############################
#p         *  2 * 2 *  * * *  #
# # # #*# # #         #*#*#*# #
#   *     ***  *      *   * * #
# # # #       # #*#*# # # # #*#
#f           **  *  *   2     #
# # # # # # # # # #*# #*# # # #
#*  *      *  *         2     #
# # # # #*# # # #*#*# # # # # #
#*    **  *  4    *           #
# #*# # # # # # #*# # # # # # #
#           *   *  *          #
###############################