1 13 31
###############################
#p         *  4 * 2 *  * * *  #
# # # #*# # #         #*#*#*# #
#   *     ***  *  2   * 2 * * #
# # # #       # #*#*# # # # #*#
#f           **  *  *   2     #
# # # # # # # # # #*# #*# # # #
#*  *      *  *               #
# # # # #*# # # #*#*# # # # # #
#*    **  *       *           #
# #*# # # # # # #*# # # # # # #
#           *   *  *          #
###############################