1 13 31
###############################
#p         *  4 * 4 *  * * *  #
# # # #*# # #         #*#*#*# #
#   *     ***  *  4   * 4 * * #
# # # #       # #*#*# # # # #*#
#f           **  *  *   4     #
# # # # # # # # # #*# #*# # # #
#*  *      *  *               #
# # # # #*# # # #*#*# # # # # #
#*    **  *  4    *           #
# #*# # # # # # #*# # # # # # #
#           *   *  *          #
###############################